######## ########
#......###......#
#......| |......#
#......###......#
######## ########