######## ########
#......###......#
#......|.|......#
#......###......#
######## ########