######## #########
#......###.......#
#..@...|.|....S..#
#......###.......#
######## ####|####


