######## #########
#......###.......#
#..P...|.|.......#
#......###.......#
######## ####|####
            #.#
            #.#
            #.#
#############|##########################
#.................#..X..#..............#
#.................#.....#..............#
#.................#.....|..............#
#.................#.....#..............#
#.................#.....#..............#
####|#############################|#####
   #.#                           #.#
   #.#                           #.#
####|#######               #######|####
#..........#################..........#
#..........|...............|..........#
#..........#################..........#
############               ############