######## #########
#......###.......#
#..@...|.|...R...#
#......###.......#
######## ####|####
            #.#
            #.#
            #.#
#############|##########################
#.................#.....#..............#
#.................#.....#..............#
#...S......S......#.....|..............#
#.................#.....#..............#
#.....S...........#.....#..............#
####|#############################|#####
   #.#                           #.#
   #.#                           #.#
####|#######               #######|####
#..........#################..........#
#..........|...............|..........#
#..........#################..........#
############               ############